Blazhchuk	Taras
Brosse 	Coline
Caranese	Tom
Carreira 	carla
Carreira Cravo	Marta
Chaouch 	Majda
Delamaere 	LÃ©o
Djoko Tsemo	Yanis
Dorn	Romain
El Moussaoui	Yasmina
Esteve	Luka
Fernandes Dos Santos 	Terry 
Grondard 	Baptiste
Lemtalsi	Meriame
Merouco 	Tony
Mishid 	Eva
Morim-Mahot	Evan
Sabhi	Oussama
Sortais 	Aurore
Thirot 	Victorien
Vaquer 	Margaux

